111111111
100C000E1
110000011
1P0000101
111111111